11111111111111111111111111111111
10000000000000000000000000000001
10000000000000000000000000000001
10000000000000000000000000000001
10000022222000030303000000000001
10000020002000000000000000000001
10000020002000030003000000000001
10000020002000000000000000000001
10000022022000030303000000000001
10000000000000000000000000000001
10000000000000000000000000000001
10000000000000000000000000000001
10000000000000000000000000000001
10000000000000000000000000000001
10000000000000000000000000000001
10000000000000000000000000000001
14444444400000000000000000000001
14040000400000000000000000000001
14000050400000000000000000000001
14040000400000000000000000000001
14044444400000000000000000000001
14000000000000000000000000000001
14444444400000000000000000000001
11111111111111111111111111111111
