44444444444444444444444444444444
10000000000000000000000000000111
10333333333333333333333333030111
10222222222222222222222222020111
10225555555555555555555552020111
10222000000000000000000000020111
10222333333333333330335552020111
10222222233333333330225552020111
10222222200000000000225552020111
10225552233333333330525552020111
10222000000000000000225552020111
10222333330333333333325552020111
12222222200000000000005552020111
10000222333333333333305552000111
12220222222222222222202020120111
10000333333333333333303333030111
10000000000000000000000000000111
10333333333333333333333333030111
10222222222222222222222222020111
10333333333333333333355202020111
10222222222222222222222552022111
10225555555555555555522552020111
10222000000000000000022552020111
10333333333333333333302552020111
10225555555555555555502552020111
10222333333333333333502552020111
10222000000000000000102552020111
10222333333333333333335552020111
10225555555500555555555552020111
10000000000000000000000000000111
10000000000000000000000000000001
77777777777777777777777777777777
